add up (to) — combine to produce a result; total a sum
answer back — reply rudely to someone in authority
ask out — invite someone on a date
back down — stop insisting because of opposition
back up — support someone; make a data copy
black out — make dark; lose consciousness
blend in — look similar and not noticeable
blurt out — say something suddenly without thinking
board up — cover doors/windows with wooden boards
break down — divide into parts
break up — destroy into pieces; end a meeting; end a relationship
brighten up — become sunnier; feel happier; add color/light
bring about — cause something to happen
bring out — reveal a quality; release a product
bring together — unite people
brush up (on) — improve skills by practice
build up — develop gradually; increase; make stronger; exaggerate
bump into — hit accidentally; meet unexpectedly
buy off — bribe someone
buy out — buy partner’s share
buy up — buy large quantities
cancel out — remove the effect of something
carry over — transfer to next period
catch on — become popular; understand
centre around — focus on
chance upon — find by accident
change around — rearrange
change into — transform; change clothes
change out of — remove clothes
check out — examine; verify information
clock up — reach a total amount
close up — lock a building
club together — collect money together
come across — find by chance
come around — change opinion; regain consciousness; visit; recur
come between — cause conflict
come out — be removed; be spoken; be released; become known; result; appear
come out with — say suddenly
come round — regain consciousness; change mind; visit; recur
come up with — think of an idea
cool down — become cooler
cordon off — block access
cotton on — realize
crack down (on) — become stricter
crease up — laugh a lot
creep up on — approach quietly
crop up — appear unexpectedly
crowd around — gather around
cut back (on) — reduce
cut out — remove by cutting; stop doing
die out — disappear
dig up — excavate; discover information
dive in — start enthusiastically
do away with — abolish
do up — fasten; renovate
drum up — generate support
dry up — lose water; become unavailable; stop speaking
end up — finally be in a situation
face up to — accept and deal with
fade away — disappear slowly
fall behind — lag behind
figure out — understand or solve
fix up — repair
follow up — check later; investigate
get across — communicate clearly
get around — spread news
get down — feel depressed
get in — be elected
get into — become involved; arrive; start enjoying
get off — have holiday; escape punishment; send
get over — recover; solve problem
get through — finish; survive; use up; connect by phone; make understand
give in — surrender; give way to temptation
go astray — get lost
go down — be received
go in for — choose; like
go off — explode; spoil; leave; lose interest
go together — exist together; match
grow on — start liking gradually
hang out — lean out; spend time socially
head off — intercept; prevent
heat up — make hot
hit back — retaliate verbally or physically
hit upon — discover; have an idea
hold back — restrain
keep up — continue; match speed
key in — enter data
kick off — begin
kill off — destroy completely
knock off — stop working
knock down — demolish
knuckle down — start working seriously
lash out — attack verbally or physically
lay off — dismiss workers; stop doing
laze around — relax lazily
let on — reveal secret
lie ahead — be in the future
liven up — make more exciting
lock up — secure building; imprison
make into — transform
make out — see/hear with difficulty; imply
make over — change appearance
make up — compensate time
meet up — meet
mess around — behave foolishly; waste time
mess up — ruin; make dirty
mix up — confuse; mix randomly
mount up — increase
move in — start living somewhere
move on — leave; change topic
move out — leave permanently
move over — make space
mull over — think carefully
open up — liberalize; open; share feelings
opt out — choose not to participate
paper over — hide problems
pass away — die
pass on — transmit
patch up — reconcile; treat injury; repair
pay back — repay money
pay out — distribute money; spend heavily
phase out — discontinue gradually
pick on — bully
pick up — collect; improve; learn unintentionally
piece together — reconstruct information
pile up — accumulate
play up — malfunction; misbehave
press ahead — continue determinedly
prop up — support financially or physically
pull over — stop vehicle
pull through — survive; succeed with help
push around — bully
put across — explain clearly
put down to — attribute cause
put in — install; apply; invest effort
put together — assemble; organize
put up — build; accommodate
puzzle out — solve
read up on — study by reading
run down — reduce activity
scrape through — barely succeed
seek out — search actively
set down — record officially; write
set out — begin
set up — assemble; establish
shout down — drown out voice
shrivel up — shrink; weaken
single out — select for attention
size up — evaluate
slip away — leave quietly
slip up — make mistake
smarten up — improve appearance
snow under — overload with work
sound out — test opinion
speak out — express publicly
spread out — disperse
spring up — appear suddenly
stand out — be noticeable; be outstanding
stand up to — resist
step aside — resign; move aside
stop off — visit briefly
store up — accumulate
summon up — gather strength
switch on/off — activate/deactivate
swot up — study hard
take after — resemble
take apart — dismantle
take away — subtract; remove
take down — dismantle; write
take in — accept; include; deceive; understand
take off — become popular; leave ground; take holiday
take on — accept responsibility; hire
take out — entertain; remove
take over — replace; control
take to — like; form habit
talk down to — patronize
talk over — discuss
talk round — persuade
test out — try
think over — consider
think through — analyze carefully
think up — invent
throw out — expel; discard; reject
throw up — raise dust; produce problems
tide over — help temporarily
tip up — tilt; empty container
touch up — improve slightly
turn into — transform
use up — consume completely
walk out — leave meeting; abandon relationship
ward off — prevent harm
warm up — prepare physically
waste away — weaken gradually
water down — dilute; weaken meaning
wear down — exhaust; erode
wear out — use until broken
weigh down — burden
while away — pass time lazily
wind down — finish gradually; relax
write off — destroy completely; consider hopeless
